################################
#.............M...............E#
#..########...........########.#
#..#......#....L....#.......M#.#
#..#......#.........#........#.#
#..#..M...###....####...M....#.#
#..#..........................#.#
#..########..........##########.#
#..............M...............#
#..............................#
################################
