####################
#................ME#
#....####..........#
#....#..#..........#
#....#..#..........#
#....#..#..........#
#....#..#####......#
#....#............##
#....#............L#
#....#.............#
#....###############
#..................#
#S.................#
####################
