########################
#......####...........E#
#..L.....#.............#
#........#....M........#
#........#.............#
#..###########.........#
#...............####...#
#.....M................#
#.............####.....#
#.............#........#
#.....####....#........#
#.....#.......#........#
#.....#.......##########
#......................#
########################
